11111111111111
100000010000P1
1C001000000001
1E001000000B01
11111111111111
