11111111111111111
110C000C100000001
10000000100C00001
11000C001000E00E1
1P0000000000000P1
11111111111111111
