11111111111111111
110C000C100000001
10000000100C00001
11000C001000000E1
110000000000000P1
11111111111111111
