1111111111111
10C10000000C1
1000011111001
10P011E000001
1111111111111
