11111111111
111P00000E1
11111111111
