1111111111
11P00000C1
1111111111
