111111111
1E00000C1
111111111
