111111111
1E0PPP0C1
111111111
