111111111111
1P0000001
11C0000011111
111E000000011
111111111111

