111111111111111111111111111111111111111111111111111111
1E1000000000000000000010000000000000000100000000000001
101000000000000000000111000000000000000000000010000001
1000000000000000000011111C00000000000000C1000000000001
111000000000000000000000000000000000000001100000000001
10000000000000000000111110000C000000000011000000000001
1C000000000000000000011100000001000000000100000000C001
11P00000100000000000C010000000000000000011100000000001
111111111111111111111111111111111111111111111111111111
